{
    "instances": [
        {
            "type": 1,
            "data": {
                "x": 50,
                "y": 100,
                "points": 1
            }
        },
        [1, 100, 200]
    ],
    "matrix": [
        [1, 1, 1, 1, 1, 1, 1, 1, 1, 1],
        [1, 0, 0, 0, 0, 0, 0, 0, 0, 1],
        [1, 0, 1, 0, 1, 1, 0, 0, 0, 1],
        [1, 0, 1, 2, 1, 0, 1, 1, 0, 1],
        [1, 0, 0, 0, 1, 0, 1, 1, 0, 1],
        [1, 0, 1, 1, 1, 0, 0, 0, 0, 1],
        [1, 1, 1, 1, 1, 1, 1, 1, 1, 1]
    ],
    "cellWidth": 32,
    "cellHeight": 32
}