{
    "attributes":{
        "score":1
    },
    "matrix": [
        [1, 1, 1, 1, 1, 1, 1, 1, 1, 1],
        [1, 0, 0, 0, 0, 0, 0, 0, 0, 1],
        [1, 0, 1, 0, 1, 1, 0, 0, 0, 1],
        [1, 0, 1, 2, 1, 0, 1, 1, 0, 1],
        [1, 0, 0, 0, 1, 0, 1, 1, 0, 1],
        [1, 0, 1, 1, 1, 0, 0, 0, 0, 1],
        [1, 1, 1, 1, 1, 1, 1, 1, 1, 1]
    ],
    "cellWidth": 32,
    "cellHeight": 32
}